-23
33
-18
12
000000000000000000000000000000000000000000000000000000000
111111111111111111111111111111111111111111111111111111110
100000000000000000000000000000000000000000000000000000010
100000000000000000000000000000000000000000000000000000010
100000000000000000000000000000000000000000000000000000010
100000000000000000000000000000000000000000000000000000010
100000000000000000000000000000000000000000000000000000010
100000000000000000000000000000000000000000000000000000010
100000000000000000000000000000000000000000000000000000010
100000000000000000000000000000000000000000000000000000010
100000000000000000000000000000000000000000000000000000010
100000000000000000000000000000000000000000000000000000010
100000000000000000000000000000000111111100000000000000010
100000000000000000000000000000000111111100000000000000010
100000000000000000000000000000000111111100000000000000010
100000000000000000000000000000000111111100000000000000010
100000000000000000000000000000000111111100000000000000010
100000000000000000000000000000000111111100000000000000010
100000000000000000000000000000000111111100000000000000010
100000000000000000000000000000000000000000000000000000010
100000000000000000000000000000000000000000000000000000010
100000000000000000000000000000000000000000000000000000010
100000000000000000000000000000000000000000000000000000010
100000000000000000000000000000000000000000000000000000010
100000000000000000000000000000000000000000000000000000010
100000000000000000000000000000000000000000000000000000010
100000000000000000000000000000000000000000000000000000010
100000000000000000000000000000000000000000000000000000010
100000000000000000000000000000000000000000000000000000010
100000000000000000000000000000000000000000000000000000010
111111111111111111111111111111111111111111111111111111110
